SO ./assets/hayt.xpm


EA ./assets/brick.xpm
NO ./assets/ho.xpm
WE ./assets/wall.xpm
C 193,208,225
F 46,123,94

111111111111111
100000100000001
1000011111111111111111111
10000011000000000000010001
10000010000000000000000001
10000011000000000000010001
11101111111011111111110001
110000110000001      10001
100000010000001      10001
100000010000001      10001
10000000000000111111111011111111111
10000001000000100000000000000000001
100000010000001000000000000000000011111
11000000000000100111000000S000110010001
111111000011111001000000000000010010001
     100001   1000000000000000000010001
     100001   1000000000000000000010001
     100001   1000000000000000000000001
     100001   1000000000000000000010001
     100001   1000101010101010101010001
     100001   1001000000000000010010001
     100001   1001100000000000110010001
     100001   1000000000000000000010001
     100001   10000000000000000000100011
     100001   111111111111111111111000111
     100001                       1110001
     100001                    11111100011
     100001                    10000000001
   1110000111111               10000000001
   1000000000001               10000000001
   1000000000001               10000000001
   1000000000001               10000000001
   1000000000001               10100000101
   1000000000001               10000000001
   10011111111111111111111     11111011111
   10000000000000000000001       100001
   11110000000000000000001       100001
      10000000000000000001       100001
  1111100000000000011101111111111100001
  1000000000000000010000000000000000001
  1000100000000000010000000000000000001
  1000100000000000010000000000000000001
  1000111111011111110000000000000000001
  1000000010001    11111111111111111111
  1111111111111                        
