SO ./assets/88.xpm
NO ./assets/hayt.xpm

EA ./assets/wall.xpm
WE ./assets/4.xpm

C 0,191,255


F 171,85,9

1111111111111111
1111000000011111
11000000000000111111111111
1000000000000000000010001
1000000000000000000000001
1000000000000000000010001
100000000000N000000010001
1001000000000000010010001
100110000000000011001000111111111111111
100000000000000000001000100000000000001
100000000000000000010000100000000000111
111111100000111000000000000000000000011
100001100000111000000000000000000010011
1000001000001 1000000000000001100010011
100000100000111001001000010001100010011
110000000000000000000000000000000000011
111111100000000000000000000000000000011
100000000000000000001000100000000000001
100000000000000000010000100000000000111
111111100000111000000000000000000000011
100001100000111000000000000000000010011
1000001000001 1000000000000001100010011
100000100000111001001000010001100010011
110000000000000000000000000000000000011
111111100000000000000000000000000000011
      111111111111111111111111111111111