SO ./assets/hh4.xpm


EA ./assets/hh1.xpm
NO ./assets/hh2.xpm
WE ./assets/hh3.xpm
C 173,216,230
F 139,90,43

111111111111111
100000100000001
10000111111111111111111111
10000011000000000000010001
10000000000000000000000001
10000000000000000000010001
11101111111011111111110001
110000110000001      10001
100000010000001      10001
100000010000001      10001
10000000000000111111110011111111111
10000001000000000000000000000000001
100000010000000000000000000000000011111
110000110000000001110000000000110010001
111111111111111001000000000000010010001
              10000000000S0000000010001
              1000000000000000000010001
              1000000000000000000000001
              1000000000000000000010001
              1000000000000000000010001
              1001000000000000010010001
              1001100000000000110010001
              1000001001001000000000001
              1000000000000000000010001
              1111111111111111111111111